Area Name,Occupation Name,Base,Projection,Change,Percent Change,Average Annual Openings
United States,"Total, All Occupations",161037700,169435900,8398200,5.2,19694000
United States,Chief Executives,263200,248800,-14400,-5.5,16800
United States,General and Operations Managers,2376400,2541400,165000,6.9,230000
United States,Legislators,51900,54600,2700,5.2,4300
United States,Advertising and Promotions Managers,27600,28400,800,2.9,2700
United States,Marketing Managers,259200,280100,20900,8.1,26000
United States,Sales Managers,405700,426300,20600,5.1,39000
United States,Public Relations and Fundraising Managers,81200,87600,6400,7.9,7800
United States,Administrative Services Managers,300200,322000,21800,7.3,28100
United States,Computer and Information Systems Managers,414400,461100,46700,11.3,38800
United States,Financial Managers,653600,758300,104700,16.0,64900
United States,Industrial Production Managers,186500,187700,1200,0.6,13800
United States,Purchasing Managers,71700,74500,2800,3.9,6400
United States,"Transportation, Storage, and Distribution Managers",131300,138700,7400,5.6,11400
United States,Compensation and Benefits Managers,16400,16800,400,2.4,1400
United States,Human Resources Managers,152100,162900,10800,7.1,14400
United States,Training and Development Managers,37800,40900,3100,8.2,3800
United States,"Farmers, Ranchers, and Other Agricultural Managers",975400,966500,-8900,-0.9,95600
United States,Construction Managers,471800,518000,46200,9.8,40200
United States,"Education Administrators, Preschool and Childcare Center/Program",66700,71500,4800,7.2,5800
United States,"Education Administrators, Elementary and Secondary School",275400,286600,11200,4.1,22900
United States,"Education Administrators, Postsecondary",192600,206100,13500,7.0,16800
United States,"Education Administrators, All Other",47400,51100,3700,7.8,4200
United States,Architectural and Engineering Managers,192500,197900,5400,2.8,14600
United States,Food Service Managers,356400,394900,38500,10.8,46900
United States,Funeral Service Managers,23500,24700,1200,5.1,1900
United States,Gaming Managers,5900,6300,400,6.8,700
United States,Lodging Managers,52600,53100,500,1.0,5500
United States,Medical and Health Services Managers,406100,477600,71500,17.6,42200
United States,Natural Sciences Managers,63500,67200,3700,5.8,6100
United States,Postmasters and Mail Superintendents,13300,9600,-3700,-27.8,500
United States,"Property, Real Estate, and Community Association Managers",363000,389500,26500,7.3,31600
United States,Social and Community Service Managers,168800,190700,21900,13.0,17800
United States,Emergency Management Directors,9900,10400,500,5.1,900
United States,"Managers, All Other",1079600,1148100,68500,6.3,91300
United States,"Agents and Business Managers of Artists, Performers, and Athletes",19400,21500,2100,10.8,2600
United States,Buyers and Purchasing Agents,432200,400200,-32000,-7.4,40200
United States,"Claims Adjusters, Examiners, and Investigators",328500,314700,-13800,-4.2,25800
United States,"Insurance Appraisers, Auto Damage",17400,18200,800,4.6,1600
United States,Compliance Officers,319900,338500,18600,5.8,30700
United States,Cost Estimators,217400,236100,18700,8.6,24200
United States,Human Resources Specialists,625700,658700,33000,5.3,67700
United States,Farm Labor Contractors,1900,2000,100,5.3,200
United States,Labor Relations Specialists,79200,72600,-6600,-8.3,7000
United States,Logisticians,174900,183300,8400,4.8,17900
United States,Management Analysts,876300,994600,118300,13.5,99900
United States,"Meeting, Convention, and Event Planners",134100,143800,9700,7.2,16800
United States,Fundraisers,95400,104200,8800,9.2,11300
United States,"Compensation, Benefits, and Job Analysis Specialists",88700,94000,5300,6.0,9200
United States,Training and Development Specialists,306400,335300,28900,9.4,37300
United States,Market Research Analysts and Marketing Specialists,681900,821100,139200,20.4,90700
United States,"Business Operations Specialists, All Other",1135700,1207000,71300,6.3,119600
United States,Accountants and Auditors,1424000,1514700,90700,6.4,146000
United States,Appraisers and Assessors of Real Estate,80100,85700,5600,7.0,6700
United States,Budget Analysts,56900,59400,2500,4.4,4800
United States,Credit Analysts,75800,79500,3700,4.9,7400
United States,Financial Analysts,329500,349800,20300,6.2,30900
United States,Personal Financial Advisors,271700,290800,19100,7.0,23200
United States,Insurance Underwriters,110400,105000,-5400,-4.9,8400
United States,Financial Examiners,60900,65200,4300,7.1,5200
United States,Credit Counselors,40100,43600,3500,8.7,3800
United States,Loan Officers,316200,340600,24400,7.7,29900
United States,"Tax Examiners and Collectors, and Revenue Agents",58200,56800,-1400,-2.4,4600
United States,Tax Preparers,86600,91400,4800,5.5,10600
United States,"Financial Specialists, All Other",144100,153000,8900,6.2,13700
United States,Computer and Information Research Scientists,31700,37000,5300,16.7,3200
United States,Computer Systems Analysts,633900,689900,56000,8.8,53400
United States,Information Security Analysts,112300,147700,35400,31.5,12800
United States,Computer Programmers,250300,232300,-18000,-7.2,15100
United States,"Software Developers, Applications",944200,1185700,241500,25.6,99200
United States,"Software Developers, Systems Software",421300,463900,42600,10.1,35400
United States,Web Developers,160500,181400,20900,13.0,15100
United States,Database Administrators,116900,127400,10500,9.0,9700
United States,Network and Computer Systems Administrators,383900,402100,18200,4.7,29300
United States,Computer Network Architects,159300,167700,8400,5.3,12200
United States,Computer User Support Specialists,671800,742700,70900,10.6,65100
United States,Computer Network Support Specialists,191300,203400,12100,6.3,17400
United States,"Computer Occupations, All Other",412800,455000,42200,10.2,35700
United States,Actuaries,25000,30000,5000,20.0,2200
United States,Mathematicians,2900,3600,700,24.1,300
United States,Operations Research Analysts,109700,137900,28200,25.7,10900
United States,Statisticians,44400,58000,13600,30.6,5300
United States,Miscellaneous Mathematical Science Occupations,2300,2400,100,4.3,200
United States,"Architects, Except Landscape and Naval",133900,145100,11200,8.4,11800
United States,Landscape Architects,23500,24600,1100,4.7,1900
United States,Cartographers and Photogrammetrists,11800,13500,1700,14.4,1100
United States,Surveyors,49200,52200,3000,6.1,4000
United States,Aerospace Engineers,67200,68300,1100,1.6,4500
United States,Agricultural Engineers,2600,2800,200,7.7,200
United States,Biomedical Engineers,19800,20500,700,3.5,1500
United States,Chemical Engineers,33900,36000,2100,6.2,2400
United States,Civil Engineers,326800,347300,20500,6.3,28300
United States,Computer Hardware Engineers,64400,68400,4000,6.2,5200
United States,Electrical Engineers,191900,201100,9200,4.8,13900
United States,"Electronics Engineers, Except Computer",138500,137300,-1200,-0.9,9000
United States,Environmental Engineers,55400,58300,2900,5.2,4600
United States,"Health and Safety Engineers, Except Mining Safety Engineers and Inspectors",27000,28400,1400,5.2,2000
United States,Industrial Engineers,284600,308400,23800,8.4,22600
United States,Marine Engineers and Naval Architects,11700,12700,1000,8.5,800
United States,Materials Engineers,27700,27700,0,0.0,1700
United States,Mechanical Engineers,312900,325700,12800,4.1,22900
United States,"Mining and Geological Engineers, Including Mining Safety Engineers",5900,6100,200,3.4,500
United States,Nuclear Engineers,17700,17600,-100,-0.6,1100
United States,Petroleum Engineers,33500,34300,800,2.4,2500
United States,"Engineers, All Other",157800,163500,5700,3.6,11700
United States,Architectural and Civil Drafters,101200,103000,1800,1.8,10700
United States,Electrical and Electronics Drafters,25600,26500,900,3.5,2800
United States,Mechanical Drafters,58000,54000,-4000,-6.9,5400
United States,"Drafters, All Other",15000,15700,700,4.7,1700
United States,Aerospace Engineering and Operations Technicians,10500,11000,500,4.8,1100
United States,Civil Engineering Technicians,73800,77400,3600,4.9,7700
United States,Electrical and Electronics Engineering Technicians,130500,130700,200,0.2,12700
United States,Electro-Mechanical Technicians,14000,14100,100,0.7,1400
United States,Environmental Engineering Technicians,17900,19500,1600,8.9,2000
United States,Industrial Engineering Technicians,68300,67800,-500,-0.7,6600
United States,Mechanical Engineering Technicians,42600,43800,1200,2.8,4300
United States,"Engineering Technicians, Except Drafters, All Other",87100,89400,2300,2.6,8800
United States,Surveying and Mapping Technicians,56800,59900,3100,5.5,7200
United States,Animal Scientists,2700,2800,100,3.7,300
United States,Food Scientists and Technologists,14900,15700,800,5.4,1800
United States,Soil and Plant Scientists,18000,19400,1400,7.8,2200
United States,Biochemists and Biophysicists,30400,32300,1900,6.3,3100
United States,Microbiologists,21700,22700,1000,4.6,2100
United States,Zoologists and Wildlife Biologists,19300,20200,900,4.7,1900
United States,"Biological Scientists, All Other",47100,49800,2700,5.7,4700
United States,Conservation Scientists,23800,24700,900,3.8,2600
United States,Foresters,9000,9200,200,2.2,1000
United States,Epidemiologists,7600,8000,400,5.3,700
United States,"Medical Scientists, Except Epidemiologists",130700,141200,10500,8.0,13200
United States,"Life Scientists, All Other",7600,8000,400,5.3,700
United States,Astronomers,2400,2500,100,4.2,200
United States,Physicists,19200,21000,1800,9.4,1800
United States,Atmospheric and Space Scientists,10000,10800,800,8.0,1100
United States,Chemists,87700,90900,3200,3.6,8400
United States,Materials Scientists,8100,8300,200,2.5,800
United States,"Environmental Scientists and Specialists, Including Health",85000,92000,7000,8.2,10300
United States,"Geoscientists, Except Hydrologists and Geographers",31000,32800,1800,5.8,3600
United States,Hydrologists,6700,7100,400,6.0,800
United States,"Physical Scientists, All Other",20900,21600,700,3.3,1900
United States,Economists,21000,22800,1800,8.6,1800
United States,Survey Researchers,12600,12800,200,1.6,1500
United States,"Clinical, Counseling, and School Psychologists",162000,185800,23800,14.7,14600
United States,Industrial-Organizational Psychologists,1400,1600,200,14.3,100
United States,"Psychologists, All Other",18300,20400,2100,11.5,1600
United States,Sociologists,3000,3300,300,10.0,400
United States,Urban and Regional Planners,39100,43300,4200,10.7,4200
United States,Anthropologists and Archeologists,6500,7100,600,9.2,800
United States,Geographers,1500,1600,100,6.7,200
United States,Historians,3300,3500,200,6.1,400
United States,Political Scientists,6200,6500,300,4.8,800
United States,"Social Scientists and Related Workers, All Other",39400,41500,2100,5.3,4800
United States,Agricultural and Food Science Technicians,29200,31000,1800,6.2,3800
United States,Biological Technicians,85000,90700,5700,6.7,9800
United States,Chemical Technicians,70300,71500,1200,1.7,7200
United States,Geological and Petroleum Technicians,16300,17400,1100,6.7,1800
United States,Nuclear Technicians,7600,7300,-300,-3.9,900
United States,Social Science Research Assistants,39600,43100,3500,8.8,5300
United States,"Environmental Science and Protection Technicians, Including Health",34800,38000,3200,9.2,4600
United States,Forensic Science Technicians,16700,19100,2400,14.4,2400
United States,Forest and Conservation Technicians,32700,33300,600,1.8,4000
United States,"Life, Physical, and Social Science Technicians, All Other",72400,77400,5000,6.9,9400
United States,"Educational, Guidance, School, and Vocational Counselors",324500,351700,27200,8.4,37300
United States,Marriage and Family Therapists,55300,67700,12400,22.4,7500
United States,Rehabilitation Counselors,119700,131500,11800,9.9,14000
United States,"Substance Abuse, Behavioral Disorder, and Mental Health Counselors",304500,373100,68600,22.5,41500
United States,"Counselors, All Other",29800,32900,3100,10.4,3500
United States,"Child, Family, and School Social Workers",339800,364600,24800,7.3,36900
United States,Healthcare Social Workers,180500,211100,30600,17.0,22200
United States,Mental Health and Substance Abuse Social Workers,125200,147500,22300,17.8,15500
United States,"Social Workers, All Other",62000,65400,3400,5.5,6600
United States,Health Educators,62100,68500,6400,10.3,8000
United States,Probation Officers and Correctional Treatment Specialists,91600,94600,3000,3.3,8200
United States,Social and Human Service Assistants,413700,466000,52300,12.6,57500
United States,Community Health Workers,61700,69400,7700,12.5,8200
United States,"Community and Social Service Specialists, All Other",106300,114900,8600,8.1,13300
United States,Clergy,234000,247800,13800,5.9,27500
United States,"Directors, Religious Activities and Education",159000,166300,7300,4.6,20900
United States,"Religious Workers, All Other",60400,63400,3000,5.0,8300
United States,Lawyers,823900,874000,50100,6.1,45700
United States,Judicial Law Clerks,17100,17700,600,3.5,800
United States,"Administrative Law Judges, Adjudicators, and Hearing Officers",15200,15500,300,2.0,800
United States,"Arbitrators, Mediators, and Conciliators",7700,8300,600,7.8,400
United States,"Judges, Magistrate Judges, and Magistrates",29800,30800,1000,3.4,1500
United States,Paralegals and Legal Assistants,325700,364800,39100,12.0,40400
United States,Court Reporters,15700,16800,1100,7.0,1600
United States,"Title Examiners, Abstractors, and Searchers",62600,62500,-100,-0.2,5500
United States,"Legal Support Workers, All Other",48100,48900,800,1.7,4400
United States,"Business Teachers, Postsecondary",108000,123900,15900,14.7,11200
United States,"Computer Science Teachers, Postsecondary",40200,41900,1700,4.2,3600
United States,"Mathematical Science Teachers, Postsecondary",61100,62900,1800,2.9,5300
United States,"Architecture Teachers, Postsecondary",8900,9600,700,7.9,800
United States,"Engineering Teachers, Postsecondary",47500,52800,5300,11.2,4700
United States,"Agricultural Sciences Teachers, Postsecondary",13300,13900,600,4.5,1200
United States,"Biological Science Teachers, Postsecondary",64500,72000,7500,11.6,6400
United States,"Forestry and Conservation Science Teachers, Postsecondary",2600,2700,100,3.8,200
United States,"Atmospheric, Earth, Marine, and Space Sciences Teachers, Postsecondary",13400,13900,500,3.7,1200
United States,"Chemistry Teachers, Postsecondary",26700,28400,1700,6.4,2400
United States,"Environmental Science Teachers, Postsecondary",7600,8000,400,5.3,700
United States,"Physics Teachers, Postsecondary",17300,18400,1100,6.4,1600
United States,"Anthropology and Archeology Teachers, Postsecondary",7300,7800,500,6.8,700
United States,"Area, Ethnic, and Cultural Studies Teachers, Postsecondary",12600,13500,900,7.1,1200
United States,"Economics Teachers, Postsecondary",16400,17700,1300,7.9,1500
United States,"Geography Teachers, Postsecondary",4800,5100,300,6.3,400
United States,"Political Science Teachers, Postsecondary",20300,21800,1500,7.4,1900
United States,"Psychology Teachers, Postsecondary",47900,53500,5600,11.7,4800
United States,"Sociology Teachers, Postsecondary",17400,18500,1100,6.3,1600
United States,"Social Sciences Teachers, Postsecondary, All Other",20400,20700,300,1.5,1700
United States,"Health Specialties Teachers, Postsecondary",254800,313900,59100,23.2,29400
United States,"Nursing Instructors and Teachers, Postsecondary",69000,82800,13800,20.0,7700
United States,"Education Teachers, Postsecondary",78600,84700,6100,7.8,7400
United States,"Library Science Teachers, Postsecondary",5700,6000,300,5.3,500
United States,"Criminal Justice and Law Enforcement Teachers, Postsecondary",18100,19600,1500,8.3,1700
United States,"Law Teachers, Postsecondary",23100,25500,2400,10.4,2200
United States,"Social Work Teachers, Postsecondary",16100,17300,1200,7.5,1500
United States,"Art, Drama, and Music Teachers, Postsecondary",118900,128200,9300,7.8,11100
United States,"Communications Teachers, Postsecondary",35800,37700,1900,5.3,3200
United States,"English Language and Literature Teachers, Postsecondary",83000,86400,3400,4.1,7300
United States,"Foreign Language and Literature Teachers, Postsecondary",31900,34400,2500,7.8,3000
United States,"History Teachers, Postsecondary",25800,27400,1600,6.2,2400
United States,"Philosophy and Religion Teachers, Postsecondary",31700,34800,3100,9.8,3100
United States,Graduate Teaching Assistants,164300,173400,9100,5.5,14900
United States,"Home Economics Teachers, Postsecondary",2500,2600,100,4.0,200
United States,"Recreation and Fitness Studies Teachers, Postsecondary",20000,20900,900,4.5,1800
United States,"Vocational Education Teachers, Postsecondary",125600,121800,-3800,-3.0,9800
United States,"Postsecondary Teachers, All Other",225600,234600,9000,4.0,19900
United States,"Preschool Teachers, Except Special Education",523600,560500,36900,7.0,58100
United States,"Kindergarten Teachers, Except Special Education",134500,139700,5200,3.9,14300
United States,"Elementary School Teachers, Except Special Education",1434400,1482400,48000,3.3,112400
United States,"Middle School Teachers, Except Special and Career/Technical Education",615700,637100,21400,3.5,48300
United States,"Career/Technical Education Teachers, Middle School",11800,12100,300,2.5,900
United States,"Secondary School Teachers, Except Special and Career/Technical Education",1072500,1110600,38100,3.6,80300
United States,"Career/Technical Education Teachers, Secondary School",76600,78300,1700,2.2,5600
United States,"Special Education Teachers, Preschool",24000,25900,1900,7.9,2100
United States,"Special Education Teachers, Kindergarten and Elementary School",184300,189400,5100,2.8,14500
United States,"Special Education Teachers, Middle School",86800,89200,2400,2.8,6800
United States,"Special Education Teachers, Secondary School",142000,146300,4300,3.0,11300
United States,"Special Education Teachers, All Other",38000,40900,2900,7.6,3200
United States,Adult Basic and Secondary Education and Literacy Teachers and Instructors,67200,60200,-7000,-10.4,6600
United States,Self-Enrichment Education Teachers,369500,413100,43600,11.8,49000
United States,"Teachers and Instructors, All Other, Except Substitute Teachers",395800,429600,33800,8.5,50400
United States,Substitute Teachers,615700,636200,20500,3.3,73400
United States,Archivists,7800,8500,700,9.0,1000
United States,Curators,13700,15000,1300,9.5,1700
United States,Museum Technicians and Conservators,14400,15700,1300,9.0,1800
United States,Librarians,134800,143400,8600,6.4,14700
United States,Library Technicians,94700,91900,-2800,-3.0,14000
United States,Audio-Visual and Multimedia Collections Specialists,10500,10900,400,3.8,1000
United States,Farm and Home Management Advisors,9600,10100,500,5.2,1000
United States,Instructional Coordinators,181600,193000,11400,6.3,18600
United States,Teacher Assistants,1380300,1435700,55400,4.0,153900
United States,"Education, Training, and Library Workers, All Other",118800,125600,6800,5.7,12000
United States,Art Directors,101000,101800,800,0.8,11100
United States,Craft Artists,9800,9800,0,0.0,1100
United States,"Fine Artists, Including Painters, Sculptors, and Illustrators",28600,28800,200,0.7,3100
United States,Multimedia Artists and Animators,71600,74700,3100,4.3,8300
United States,"Artists and Related Workers, All Other",11900,12200,300,2.5,1300
United States,Commercial and Industrial Designers,43900,45300,1400,3.2,4600
United States,Fashion Designers,25800,26200,400,1.6,2600
United States,Floral Designers,55500,47900,-7600,-13.7,4400
United States,Graphic Designers,290100,299000,8900,3.1,30300
United States,Interior Designers,75400,78600,3200,4.2,8000
United States,Merchandise Displayers and Window Trimmers,168400,171600,3200,1.9,17300
United States,Set and Exhibit Designers,13700,14400,700,5.1,1500
United States,"Designers, All Other",11100,11700,600,5.4,1200
United States,Actors,64500,65100,600,0.9,7700
United States,Producers and Directors,152400,159600,7200,4.7,16000
United States,Athletes and Sports Competitors,13500,14300,800,5.9,2100
United States,Coaches and Scouts,290100,320600,30500,10.5,47600
United States,"Umpires, Referees, and Other Sports Officials",22000,23400,1400,6.4,3400
United States,Dancers,13900,14000,100,0.7,2400
United States,Choreographers,7200,7000,-200,-2.8,1200
United States,Music Directors and Composers,64700,65500,800,1.2,7800
United States,Musicians and Singers,187600,187900,300,0.2,22400
United States,"Entertainers and Performers, Sports and Related Workers, All Other",38500,39500,1000,2.6,4600
United States,Radio and Television Announcers,38300,35600,-2700,-7.0,4000
United States,Public Address System and Other Announcers,10400,10600,200,1.9,1200
United States,Broadcast News Analysts,6900,7000,100,1.4,900
United States,Reporters and Correspondents,42800,37600,-5200,-12.1,4400
United States,Public Relations Specialists,270000,287300,17300,6.4,30700
United States,Editors,118300,114900,-3400,-2.9,12400
United States,Technical Writers,55700,60400,4700,8.4,6100
United States,Writers and Authors,123200,123000,-200,-0.2,12800
United States,Interpreters and Translators,76100,90700,14600,19.2,9800
United States,"Media and Communication Workers, All Other",29000,31100,2100,7.2,3200
United States,Audio and Video Equipment Technicians,93200,104000,10800,11.6,11600
United States,Broadcast Technicians,35300,35700,400,1.1,3800
United States,Radio Operators,900,900,0,0.0,100
United States,Sound Engineering Technicians,15900,16100,200,1.3,1700
United States,Photographers,132100,123800,-8300,-6.3,11800
United States,"Camera Operators, Television, Video, and Motion Picture",29400,31800,2400,8.2,3200
United States,Film and Video Editors,39800,45300,5500,13.8,4700
United States,"Media and Communication Equipment Workers, All Other",21200,21900,700,3.3,2400
United States,Chiropractors,50300,54100,3800,7.6,1800
United States,"Dentists, General",136900,147400,10500,7.7,5300
United States,Oral and Maxillofacial Surgeons,5900,6300,400,6.8,200
United States,Orthodontists,6500,7000,500,7.7,300
United States,Prosthodontists,500,500,0,0.0,0
United States,"Dentists, All Other Specialists",5200,5400,200,3.8,200
United States,Dietitians and Nutritionists,70900,78900,8000,11.3,5500
United States,Optometrists,42100,46100,4000,9.5,1700
United States,Pharmacists,314300,314100,-200,-0.1,14100
United States,Anesthesiologists,34500,36000,1500,4.3,1200
United States,Family and General Practitioners,126600,139000,12400,9.8,5100
United States,"Internists, General",42800,44400,1600,3.7,1400
United States,Obstetricians and Gynecologists,20700,21100,400,1.9,700
United States,"Pediatricians, General",31700,32400,700,2.2,1000
United States,Psychiatrists,28600,33200,4600,16.1,1400
United States,Surgeons,38200,38700,500,1.3,1200
United States,"Physicians and Surgeons, All Other",433700,467400,33700,7.8,16500
United States,Physician Assistants,118800,155700,36900,31.1,11500
United States,Podiatrists,10500,11200,700,6.7,700
United States,Occupational Therapists,133000,156800,23800,17.9,10500
United States,Physical Therapists,247700,301900,54200,21.9,16900
United States,Radiation Therapists,18600,20200,1600,8.6,1100
United States,Recreational Therapists,19800,21200,1400,7.1,1100
United States,Respiratory Therapists,134000,162000,28000,20.9,10600
United States,Speech-Language Pathologists,153700,195600,41900,27.3,13500
United States,Exercise Physiologists,15800,17300,1500,9.5,1100
United States,"Therapists, All Other",28100,33100,5000,17.8,2200
United States,Veterinarians,84500,100100,15600,18.5,5100
United States,Registered Nurses,3059800,3431300,371500,12.1,210400
United States,Nurse Anesthetists,45000,52700,7700,17.1,3200
United States,Nurse Midwives,6500,7600,1100,16.9,500
United States,Nurse Practitioners,189100,242400,53300,28.2,16900
United States,Audiologists,13600,15800,2200,16.2,800
United States,"Health Diagnosing and Treating Practitioners, All Other",56800,63000,6200,10.9,3400
United States,Clinical Laboratory Technologists and Technicians,331700,366800,35100,10.6,25500
United States,Dental Hygienists,219800,243500,23700,10.8,17900
United States,Cardiovascular Technologists and Technicians,57800,61700,3900,6.7,3700
United States,Diagnostic Medical Sonographers,72900,87100,14200,19.5,5800
United States,Nuclear Medicine Technologists,19300,20600,1300,6.7,1200
United States,Radiologic Technologists,210500,229500,19000,9.0,14000
United States,Magnetic Resonance Imaging Technologists,39400,43700,4300,10.9,2700
United States,Emergency Medical Technicians and Paramedics,262100,280800,18700,7.1,19900
United States,Dietetic Technicians,34800,36900,2100,6.0,3100
United States,Pharmacy Technicians,420400,451900,31500,7.5,38300
United States,Psychiatric Technicians,76600,86100,9500,12.4,7500
United States,Respiratory Therapy Technicians,9300,3900,-5400,-58.1,0
United States,Surgical Technologists,112100,121800,9700,8.7,10400
United States,Veterinary Technologists and Technicians,109400,130500,21100,19.3,11800
United States,Ophthalmic Medical Technicians,53800,62700,8900,16.5,5600
United States,Licensed Practical and Licensed Vocational Nurses,728900,807000,78100,10.7,66300
United States,Medical Records and Health Information Technicians,215500,238600,23100,10.7,16800
United States,"Opticians, Dispensing",74500,79900,5400,7.2,6600
United States,Orthotists and Prosthetists,9100,10900,1800,19.8,900
United States,Hearing Aid Specialists,7700,9000,1300,16.9,700
United States,"Health Technologists and Technicians, All Other",128900,151300,22400,17.4,11700
United States,Occupational Health and Safety Specialists,98000,104000,6000,6.1,6300
United States,Occupational Health and Safety Technicians,19900,21400,1500,7.5,1300
United States,Athletic Trainers,31100,37000,5900,19.0,2500
United States,Genetic Counselors,3000,3800,800,26.7,300
United States,"Healthcare Practitioners and Technical Workers, All Other",36600,40300,3700,10.1,2500
United States,Home Health Aides,831800,1136600,304800,36.6,140800
United States,Psychiatric Aides,61600,68500,6900,11.2,8000
United States,Nursing Assistants,1513200,1648600,135400,8.9,190700
United States,Orderlies,51000,53400,2400,4.7,6100
United States,Occupational Therapy Assistants,43800,58300,14500,33.1,7000
United States,Occupational Therapy Aides,7900,9400,1500,19.0,1100
United States,Physical Therapist Assistants,98400,125000,26600,27.0,16500
United States,Physical Therapist Aides,49800,61200,11400,22.9,8000
United States,Massage Therapists,159800,195200,35400,22.2,24200
United States,Dental Assistants,346000,384700,38700,11.2,44800
United States,Medical Assistants,686600,841500,154900,22.6,99700
United States,Medical Equipment Preparers,57600,62200,4600,8.0,7300
United States,Medical Transcriptionists,58000,56000,-2000,-3.4,7700
United States,Pharmacy Aides,37000,32600,-4400,-11.9,4000
United States,Veterinary Assistants and Laboratory Animal Caretakers,92200,109800,17600,19.1,18100
United States,Phlebotomists,128300,157800,29500,23.0,18100
United States,"Healthcare Support Workers, All Other",92600,100200,7600,8.2,11700
United States,First-Line Supervisors of Correctional Officers,45900,42500,-3400,-7.4,2800
United States,First-Line Supervisors of Police and Detectives,121600,127400,5800,4.8,8300
United States,First-Line Supervisors of Fire Fighting and Prevention Workers,68000,71700,3700,5.4,4800
United States,"First-Line Supervisors of Protective Service Workers, All Other",83100,84700,1600,1.9,8100
United States,Firefighters,332400,350000,17600,5.3,25000
United States,Fire Inspectors and Investigators,13000,13700,700,5.4,1300
United States,Forest Fire Inspectors and Prevention Specialists,2200,2800,600,27.3,300
United States,Bailiffs,19600,19400,-200,-1.0,1700
United States,Correctional Officers and Jailers,434300,402900,-31400,-7.2,33800
United States,Detectives and Criminal Investigators,110700,113500,2800,2.5,7500
United States,Fish and Game Wardens,6400,6500,100,1.6,500
United States,Parking Enforcement Workers,8600,5400,-3200,-37.2,200
United States,Police and Sheriff's Patrol Officers,687100,721600,34500,5.0,52900
United States,Transit and Railroad Police,4500,4700,200,4.4,300
United States,Animal Control Workers,12500,13200,700,5.6,1300
United States,Private Detectives and Investigators,33000,35600,2600,7.9,3300
United States,Gaming Surveillance Officers and Gaming Investigators,10500,10900,400,3.8,1400
United States,Security Guards,1143800,1184000,40200,3.5,153800
United States,Crossing Guards,81700,86300,4600,5.6,14200
United States,"Lifeguards, Ski Patrol, and Other Recreational Protective Service Workers",151800,162400,10600,7.0,39000
United States,Transportation Security Screeners,49100,49600,500,1.0,4700
United States,"Protective Service Workers, All Other",141000,147100,6100,4.3,35400
United States,Chefs and Head Cooks,139000,154300,15300,11.0,20700
United States,First-Line Supervisors of Food Preparation and Serving Workers,988900,1096100,107200,10.8,169900
United States,"Cooks, Fast Food",491300,453200,-38100,-7.8,63000
United States,"Cooks, Institution and Cafeteria",418500,437800,19300,4.6,62500
United States,"Cooks, Private Household",38300,39800,1500,3.9,5700
United States,"Cooks, Restaurant",1362300,1661300,299000,21.9,243800
United States,"Cooks, Short Order",158300,157300,-1000,-0.6,22200
United States,"Cooks, All Other",23300,24700,1400,6.0,3500
United States,Food Preparation Workers,842100,911200,69100,8.2,158500
United States,Bartenders,644100,696300,52200,8.1,123100
United States,"Combined Food Preparation and Serving Workers, Including Fast Food",3704200,4344300,640100,17.3,780600
United States,"Counter Attendants, Cafeteria, Food Concession, and Coffee Shop",480200,496300,16100,3.4,107600
United States,Waiters and Waitresses,2634600,2804800,170200,6.5,539000
United States,"Food Servers, Nonrestaurant",273800,294600,20800,7.6,46500
United States,Dining Room and Cafeteria Attendants and Bartender Helpers,465900,511100,45200,9.7,88000
United States,Dishwashers,516600,533500,16900,3.3,85000
United States,"Hosts and Hostesses, Restaurant, Lounge, and Coffee Shop",425600,472700,47100,11.1,107600
United States,"Food Preparation and Serving Related Workers, All Other",57000,63000,6000,10.5,10800
United States,First-Line Supervisors of Housekeeping and Janitorial Workers,245300,262000,16700,6.8,30400
United States,"First-Line Supervisors of Landscaping, Lawn Service, and Groundskeeping Workers",199100,216400,17300,8.7,24300
United States,"Janitors and Cleaners, Except Maids and Housekeeping Cleaners",2404400,2564200,159800,6.6,343100
United States,Maids and Housekeeping Cleaners,1494400,1469000,-25400,-1.7,197000
United States,"Building Cleaning Workers, All Other",14800,16100,1300,8.8,2200
United States,Pest Control Workers,84500,90400,5900,7.0,12600
United States,Landscaping and Groundskeeping Workers,1205200,1311600,106400,8.8,173600
United States,"Pesticide Handlers, Sprayers, and Applicators, Vegetation",35700,38200,2500,7.0,5000
United States,Tree Trimmers and Pruners,55600,61100,5500,9.9,8100
United States,"Grounds Maintenance Workers, All Other",17700,18600,900,5.1,2400
United States,First-Line Supervisors of Gaming Workers,49700,54200,4500,9.1,8800
United States,First-Line Supervisors of Personal Service Workers,302200,336700,34500,11.4,34400
United States,Animal Trainers,45300,51200,5900,13.0,7600
United States,Nonfarm Animal Caretakers,285600,331400,45800,16.0,54500
United States,Gaming Dealers,95500,99500,4000,4.2,15500
United States,Gaming and Sports Book Writers and Runners,11700,11600,-100,-0.9,1800
United States,"Gaming Service Workers, All Other",10300,10500,200,1.9,1600
United States,Motion Picture Projectionists,4900,4300,-600,-12.2,800
United States,"Ushers, Lobby Attendants, and Ticket Takers",136400,140600,4200,3.1,34100
United States,Amusement and Recreation Attendants,338600,364400,25800,7.6,83500
United States,Costume Attendants,6700,7000,300,4.5,1600
United States,"Locker Room, Coatroom, and Dressing Room Attendants",18500,19700,1200,6.5,4500
United States,"Entertainment Attendants and Related Workers, All Other",5800,6000,200,3.4,1400
United States,Embalmers,4200,4100,-100,-2.4,700
United States,Funeral Attendants,36100,37100,1000,2.8,6000
United States,"Morticians, Undertakers, and Funeral Directors",29600,30300,700,2.4,3600
United States,Barbers,82300,88400,6100,7.4,10100
United States,"Hairdressers, Hairstylists, and Cosmetologists",683800,741700,57900,8.5,94600
United States,"Makeup Artists, Theatrical and Performance",4500,4800,300,6.7,600
United States,Manicurists and Pedicurists,156300,172000,15700,10.0,20300
United States,Shampooers,19500,21400,1900,9.7,2500
United States,Skincare Specialists,71800,79600,7800,10.9,9400
United States,Baggage Porters and Bellhops,43100,45700,2600,6.0,6600
United States,Concierges,38200,40200,2000,5.2,5800
United States,Tour and Travel Guides,61900,66100,4200,6.8,11600
United States,Childcare Workers,1160000,1187700,27700,2.4,177900
United States,Personal Care Aides,2421200,3302100,880900,36.4,486900
United States,Fitness Trainers and Aerobics Instructors,356900,402500,45600,12.8,67600
United States,Recreation Workers,408300,442000,33700,8.3,74000
United States,Residential Advisors,115800,129600,13800,11.9,20000
United States,"Personal Care and Service Workers, All Other",112900,122100,9200,8.1,18100
United States,First-Line Supervisors of Retail Sales Workers,1548300,1518100,-30200,-2.0,165500
United States,First-Line Supervisors of Non-Retail Sales Workers,397600,390700,-6900,-1.7,37000
United States,Cashiers,3648500,3509800,-138700,-3.8,661300
United States,Gaming Change Persons and Booth Cashiers,22600,22800,200,0.9,4300
United States,Counter and Rental Clerks,436100,453200,17100,3.9,58700
United States,Parts Salespersons,258000,254700,-3300,-1.3,30500
United States,Retail Salespersons,4510900,4409100,-101800,-2.3,641300
United States,Advertising Sales Agents,147900,144600,-3300,-2.2,19500
United States,Insurance Sales Agents,475900,524200,48300,10.1,53400
United States,"Securities, Commodities, and Financial Services Sales Agents",442400,460900,18500,4.2,44600
United States,Travel Agents,78800,74400,-4400,-5.6,9700
United States,"Sales Representatives, Services, All Other",1060600,1137000,76400,7.2,146800
United States,"Sales Representatives, Wholesale and Manufacturing, Technical and Scientific Products",325900,338000,12100,3.7,36000
United States,"Sales Representatives, Wholesale and Manufacturing, Except Technical and Scientific Products",1406400,1429800,23400,1.7,151100
United States,Demonstrators and Product Promoters,87400,92000,4600,5.3,15800
United States,Models,3600,3400,-200,-5.6,600
United States,Real Estate Brokers,96200,103000,6800,7.1,10100
United States,Real Estate Sales Agents,369200,394800,25600,6.9,38900
United States,Sales Engineers,66700,70400,3700,5.5,7900
United States,Telemarketers,167700,139800,-27900,-16.6,21400
United States,"Door-to-Door Sales Workers, News and Street Vendors, and Related Workers",69900,64900,-5000,-7.2,7800
United States,"Sales and Related Workers, All Other",107900,113200,5300,4.9,14900
United States,First-Line Supervisors of Office and Administrative Support Workers,1557500,1544200,-13300,-0.9,161100
United States,"Switchboard Operators, Including Answering Service",73400,55900,-17500,-23.8,6300
United States,Telephone Operators,5700,4100,-1600,-28.1,500
United States,"Communications Equipment Operators, All Other",2200,2400,200,9.1,300
United States,Bill and Account Collectors,258000,238600,-19400,-7.5,27700
United States,Billing and Posting Clerks,486300,536300,50000,10.3,60500
United States,"Bookkeeping, Accounting, and Auditing Clerks",1707700,1641900,-65800,-3.9,188500
United States,Gaming Cage Workers,16300,16800,500,3.1,2300
United States,Payroll and Timekeeping Clerks,150400,145600,-4800,-3.2,15800
United States,Procurement Clerks,70800,66500,-4300,-6.1,6700
United States,Tellers,472100,414300,-57800,-12.2,47600
United States,"Financial Clerks, All Other",33800,36200,2400,7.1,4000
United States,Brokerage Clerks,56100,58700,2600,4.6,6200
United States,Correspondence Clerks,5900,5800,-100,-1.7,700
United States,"Court, Municipal, and License Clerks",150500,157200,6700,4.5,14900
United States,"Credit Authorizers, Checkers, and Clerks",30300,28900,-1400,-4.6,2800
United States,Customer Service Representatives,2972600,2921000,-51600,-1.7,387600
United States,"Eligibility Interviewers, Government Programs",145200,151600,6400,4.4,14700
United States,File Clerks,116900,101100,-15800,-13.5,11900
United States,"Hotel, Motel, and Resort Desk Clerks",265400,248700,-16700,-6.3,41900
United States,"Interviewers, Except Eligibility and Loan",204600,211000,6400,3.1,26200
United States,"Library Assistants, Clerical",94400,91600,-2800,-3.0,13700
United States,Loan Interviewers and Clerks,226300,245800,19500,8.6,25900
United States,New Accounts Clerks,41900,38800,-3100,-7.4,4400
United States,Order Clerks,166800,165700,-1100,-0.7,19100
United States,"Human Resources Assistants, Except Payroll and Timekeeping",129300,123900,-5400,-4.2,13800
United States,Receptionists and Information Clerks,1101500,1160800,59300,5.4,157900
United States,Reservation and Transportation Ticket Agents and Travel Clerks,133700,137800,4100,3.1,15800
United States,"Information and Record Clerks, All Other",166000,174100,8100,4.9,20500
United States,Cargo and Freight Agents,95500,102700,7200,7.5,10100
United States,Couriers and Messengers,101500,104200,2700,2.7,10100
United States,"Police, Fire, and Ambulance Dispatchers",98300,103700,5400,5.5,10100
United States,"Dispatchers, Except Police, Fire, and Ambulance",206900,207200,300,0.1,19600
United States,"Meter Readers, Utilities",34200,30200,-4000,-11.7,2800
United States,Postal Service Clerks,75700,60700,-15000,-19.8,3700
United States,Postal Service Mail Carriers,328700,263700,-65000,-19.8,15500
United States,"Postal Service Mail Sorters, Processors, and Processing Machine Operators",99700,76000,-23700,-23.8,4900
United States,"Production, Planning, and Expediting Clerks",358700,373800,15100,4.2,39700
United States,"Shipping, Receiving, and Traffic Clerks",662600,656200,-6400,-1.0,64800
United States,Stock Clerks and Order Fillers,2056600,2091300,34700,1.7,279500
United States,"Weighers, Measurers, Checkers, and Samplers, Recordkeeping",66300,69900,3600,5.4,8100
United States,Executive Secretaries and Executive Administrative Assistants,622500,499400,-123100,-19.8,50500
United States,Legal Secretaries,180100,142500,-37600,-20.9,14300
United States,Medical Secretaries,601700,698100,96400,16.0,82400
United States,"Secretaries and Administrative Assistants, Except Legal, Medical, and Executive",2382500,2170000,-212500,-8.9,233500
United States,Computer Operators,36800,28000,-8800,-23.9,3100
United States,Data Entry Keyers,187300,143900,-43400,-23.2,14800
United States,Word Processors and Typists,60400,40000,-20400,-33.8,4100
United States,Desktop Publishers,12600,10600,-2000,-15.9,1200
United States,Insurance Claims and Policy Processing Clerks,308800,321800,13000,4.2,32700
United States,"Mail Clerks and Mail Machine Operators, Except Postal Service",90100,84200,-5900,-6.5,9100
United States,"Office Clerks, General",3158500,3047800,-110700,-3.5,360400
United States,"Office Machine Operators, Except Computer",50100,43700,-6400,-12.8,5300
United States,Proofreaders and Copy Markers,14700,15300,600,4.1,2100
United States,Statistical Assistants,13100,14100,1000,7.6,1800
United States,"Office and Administrative Support Workers, All Other",228100,241200,13100,5.7,28600
United States,"First-Line Supervisors of Farming, Fishing, and Forestry Workers",55700,56500,800,1.4,8400
United States,Agricultural Inspectors,17700,18400,700,4.0,2700
United States,Animal Breeders,8900,9200,300,3.4,1500
United States,"Graders and Sorters, Agricultural Products",40100,39500,-600,-1.5,5800
United States,Agricultural Equipment Operators,66600,73100,6500,9.8,12100
United States,"Farmworkers and Laborers, Crop, Nursery, and Greenhouse",532300,542700,10400,2.0,88800
United States,"Farmworkers, Farm, Ranch, and Aquacultural Animals",256100,249200,-6900,-2.7,40600
United States,"Agricultural Workers, All Other",12400,13000,600,4.8,2100
United States,Forest and Conservation Workers,13900,13500,-400,-2.9,2400
United States,Fallers,6600,5400,-1200,-18.2,800
United States,Logging Equipment Operators,36900,31800,-5100,-13.8,5000
United States,Log Graders and Scalers,4700,4400,-300,-6.4,700
United States,"Logging Workers, All Other",5400,4600,-800,-14.8,700
United States,First-Line Supervisors of Construction Trades and Extraction Workers,662600,731700,69100,10.4,79400
United States,Boilermakers,14500,15300,800,5.5,1600
United States,Brickmasons and Blockmasons,87000,95400,8400,9.7,10000
United States,Stonemasons,17100,18600,1500,8.8,1900
United States,Carpenters,1006500,1086600,80100,8.0,116300
United States,Carpet Installers,37200,36500,-700,-1.9,3500
United States,"Floor Layers, Except Carpet, Wood, and Hard Tiles",20100,23700,3600,17.9,2500
United States,Floor Sanders and Finishers,6400,7000,600,9.4,700
United States,Tile and Marble Setters,56000,65900,9900,17.7,6900
United States,Cement Masons and Concrete Finishers,191100,212200,21100,11.0,23300
United States,Terrazzo Workers and Finishers,2800,3200,400,14.3,400
United States,Construction Laborers,1405000,1553100,148100,10.5,179300
United States,"Paving, Surfacing, and Tamping Equipment Operators",47100,52200,5100,10.8,6700
United States,Pile-Driver Operators,3600,4000,400,11.1,500
United States,Operating Engineers and Other Construction Equipment Operators,402400,441000,38600,9.6,52500
United States,Drywall and Ceiling Tile Installers,122000,124800,2800,2.3,12600
United States,Tapers,22000,22300,300,1.4,2200
United States,Electricians,715400,789500,74100,10.4,94600
United States,Glaziers,53500,59200,5700,10.7,7000
United States,"Insulation Workers, Floor, Ceiling, and Wall",33300,34200,900,2.7,4000
United States,"Insulation Workers, Mechanical",25400,27600,2200,8.7,3300
United States,"Painters, Construction and Maintenance",375600,398000,22400,6.0,41400
United States,Paperhangers,4600,4800,200,4.3,500
United States,Pipelayers,42600,47700,5100,12.0,5500
United States,"Plumbers, Pipefitters, and Steamfitters",500300,568600,68300,13.7,66100
United States,Plasterers and Stucco Masons,27700,29000,1300,4.7,2700
United States,Reinforcing Iron and Rebar Workers,18500,20500,2000,10.8,2500
United States,Roofers,160600,179600,19000,11.8,19500
United States,Sheet Metal Workers,143000,154400,11400,8.0,17300
United States,Structural Iron and Steel Workers,80100,89300,9200,11.5,10900
United States,Solar Photovoltaic Installers,9700,15800,6100,62.9,2200
United States,"Helpers--Brickmasons, Blockmasons, Stonemasons, and Tile and Marble Setters",24400,27000,2600,10.7,3700
United States,Helpers--Carpenters,34200,38200,4000,11.7,5300
United States,Helpers--Electricians,78300,83700,5400,6.9,11400
United States,"Helpers--Painters, Paperhangers, Plasterers, and Stucco Masons",10900,11500,600,5.5,1600
United States,"Helpers--Pipelayers, Plumbers, Pipefitters, and Steamfitters",56900,65800,8900,15.6,9200
United States,Helpers--Roofers,8800,9900,1100,12.5,1400
United States,"Helpers, Construction Trades, All Other",27200,30000,2800,10.3,4100
United States,Construction and Building Inspectors,117300,125000,7700,6.6,15800
United States,Elevator Installers and Repairers,27000,29800,2800,10.4,3500
United States,Fence Erectors,31200,34400,3200,10.3,4200
United States,Hazardous Materials Removal Workers,45900,50800,4900,10.7,6600
United States,Highway Maintenance Workers,155300,162700,7400,4.8,18400
United States,Rail-Track Laying and Maintenance Equipment Operators,13900,14900,1000,7.2,1600
United States,Septic Tank Servicers and Sewer Pipe Cleaners,29600,33500,3900,13.2,4000
United States,Miscellaneous Construction and Related Workers,35400,38700,3300,9.3,4900
United States,"Derrick Operators, Oil and Gas",12200,14200,2000,16.4,2100
United States,"Rotary Drill Operators, Oil and Gas",19300,22100,2800,14.5,3200
United States,"Service Unit Operators, Oil, Gas, and Mining",52900,59900,7000,13.2,8700
United States,"Earth Drillers, Except Oil and Gas",18900,21500,2600,13.8,2900
United States,"Explosives Workers, Ordnance Handling Experts, and Blasters",5900,6200,300,5.1,800
United States,Continuous Mining Machine Operators,15100,15300,200,1.3,1900
United States,Mine Cutting and Channeling Machine Operators,5000,5000,0,0.0,600
United States,"Mining Machine Operators, All Other",3400,3500,100,2.9,400
United States,"Rock Splitters, Quarry",4900,5100,200,4.1,700
United States,"Roof Bolters, Mining",3300,3000,-300,-9.1,400
United States,"Roustabouts, Oil and Gas",58300,67000,8700,14.9,9100
United States,Helpers--Extraction Workers,16900,19000,2100,12.4,2600
United States,"Extraction Workers, All Other",6500,7300,800,12.3,1000
United States,"First-Line Supervisors of Mechanics, Installers, and Repairers",487000,506400,19400,4.0,47500
United States,"Computer, Automated Teller, and Office Machine Repairers",114500,112800,-1700,-1.5,11900
United States,"Radio, Cellular, and Tower Equipment Installers and Repairs",14200,14600,400,2.8,1600
United States,"Telecommunications Equipment Installers and Repairers, Except Line Installers",232900,219800,-13100,-5.6,23600
United States,Avionics Technicians,20600,21000,400,1.9,1500
United States,"Electric Motor, Power Tool, and Related Repairers",17200,17800,600,3.5,1900
United States,"Electrical and Electronics Installers and Repairers, Transportation Equipment",11500,11800,300,2.6,1000
United States,"Electrical and Electronics Repairers, Commercial and Industrial Equipment",61300,61700,400,0.7,5400
United States,"Electrical and Electronics Repairers, Powerhouse, Substation, and Relay",23100,23500,400,1.7,2100
United States,"Electronic Equipment Installers and Repairers, Motor Vehicles",11000,7900,-3100,-28.2,800
United States,Electronic Home Entertainment Equipment Installers and Repairers,31200,30800,-400,-1.3,3300
United States,Security and Fire Alarm Systems Installers,76400,85000,8600,11.3,10500
United States,Aircraft Mechanics and Service Technicians,136900,141200,4300,3.1,11800
United States,Automotive Body and Related Repairers,156800,163200,6400,4.1,16000
United States,Automotive Glass Installers and Repairers,20300,21200,900,4.4,2100
United States,Automotive Service Technicians and Mechanics,770100,763600,-6500,-0.8,74000
United States,Bus and Truck Mechanics and Diesel Engine Specialists,285300,299100,13800,4.8,28400
United States,Farm Equipment Mechanics and Service Technicians,45400,47100,1700,3.7,4800
United States,"Mobile Heavy Equipment Mechanics, Except Engines",150300,155700,5400,3.6,15800
United States,Rail Car Repairers,25100,25800,700,2.8,2600
United States,Motorboat Mechanics and Service Technicians,24900,26300,1400,5.6,2700
United States,Motorcycle Mechanics,16600,18100,1500,9.0,1900
United States,Outdoor Power Equipment and Other Small Engine Mechanics,34900,36900,2000,5.7,3800
United States,Bicycle Repairers,12200,13300,1100,9.0,1500
United States,Recreational Vehicle Service Technicians,15900,17300,1400,8.8,2000
United States,Tire Repairers and Changers,114500,106400,-8100,-7.1,11400
United States,Mechanical Door Repairers,23000,25200,2200,9.6,2300
United States,"Control and Valve Installers and Repairers, Except Mechanical Door",52500,53300,800,1.5,4600
United States,"Heating, Air Conditioning, and Refrigeration Mechanics and Installers",367900,414200,46300,12.6,42800
United States,Home Appliance Repairers,41000,40200,-800,-2.0,4300
United States,Industrial Machinery Mechanics,381500,400800,19300,5.1,37800
United States,"Maintenance Workers, Machinery",81100,85400,4300,5.3,8000
United States,Millwrights,44300,48200,3900,8.8,4400
United States,"Refractory Materials Repairers, Except Brickmasons",1200,1100,-100,-8.3,100
United States,Electrical Power-Line Installers and Repairers,119400,128900,9500,8.0,11400
United States,Telecommunications Line Installers and Repairers,122700,123900,1200,1.0,13900
United States,Camera and Photographic Equipment Repairers,4300,4300,0,0.0,400
United States,Medical Equipment Repairers,53800,55800,2000,3.7,6000
United States,Musical Instrument Repairers and Tuners,8900,8100,-800,-9.0,800
United States,Watch Repairers,3000,2100,-900,-30.0,200
United States,"Precision Instrument and Equipment Repairers, All Other",12500,12600,100,0.8,1300
United States,"Maintenance and Repair Workers, General",1488000,1573400,85400,5.7,156900
United States,Wind Turbine Service Technicians,6600,10300,3700,56.1,1300
United States,"Coin, Vending, and Amusement Machine Servicers and Repairers",36600,36700,100,0.3,4300
United States,Commercial Divers,4000,4300,300,7.5,500
United States,"Fabric Menders, Except Garment",500,500,0,0.0,0
United States,Locksmiths and Safe Repairers,22100,20100,-2000,-9.0,2100
United States,Manufactured Building and Mobile Home Installers,2900,2600,-300,-10.3,200
United States,Riggers,22100,23300,1200,5.4,2300
United States,Signal and Track Switch Repairers,8400,8400,0,0.0,900
United States,"Helpers--Installation, Maintenance, and Repair Workers",107200,115700,8500,7.9,15100
United States,"Installation, Maintenance, and Repair Workers, All Other",182700,193500,10800,5.9,21300
United States,First-Line Supervisors of Production and Operating Workers,639700,638500,-1200,-0.2,65200
United States,"Aircraft Structure, Surfaces, Rigging, and Systems Assemblers",45100,35200,-9900,-22.0,2500
United States,"Coil Winders, Tapers, and Finishers",12300,9700,-2600,-21.1,1000
United States,"Electrical, Electronic, and Electromechanical Assemblers, Except Coil Winders, Tapers, and Finishers",279600,271200,-8400,-3.0,30500
United States,Engine and Other Machine Assemblers,48700,40600,-8100,-16.6,4500
United States,Structural Metal Fabricators and Fitters,80400,68600,-11800,-14.7,6600
United States,Fiberglass Laminators and Fabricators,21800,21900,100,0.5,2600
United States,Timing Device Assemblers and Adjusters,800,600,-200,-25.0,100
United States,"Assemblers and Fabricators, All Other, Including Team Assemblers",1379400,1217000,-162400,-11.8,134900
United States,Bakers,191900,203000,11100,5.8,28100
United States,Butchers and Meat Cutters,135500,139500,4000,3.0,17400
United States,"Meat, Poultry, and Fish Cutters and Trimmers",164600,167200,2600,1.6,20800
United States,Slaughterers and Meat Packers,77600,79400,1800,2.3,9900
United States,"Food and Tobacco Roasting, Baking, and Drying Machine Operators and Tenders",21000,21100,100,0.5,2900
United States,Food Batchmakers,163800,167000,3200,2.0,24800
United States,Food Cooking Machine Operators and Tenders,35100,36100,1000,2.8,5700
United States,"Food Processing Workers, All Other",48900,49800,900,1.8,5300
United States,"Computer-Controlled Machine Tool Operators, Metal and Plastic",151600,138800,-12800,-8.4,13600
United States,"Computer Numerically Controlled Machine Tool Programmers, Metal and Plastic",24300,29200,4900,20.2,3200
United States,"Extruding and Drawing Machine Setters, Operators, and Tenders, Metal and Plastic",76500,68900,-7600,-9.9,8300
United States,"Forging Machine Setters, Operators, and Tenders, Metal and Plastic",18600,15000,-3600,-19.4,1200
United States,"Rolling Machine Setters, Operators, and Tenders, Metal and Plastic",27100,23800,-3300,-12.2,2100
United States,"Cutting, Punching, and Press Machine Setters, Operators, and Tenders, Metal and Plastic",188800,172800,-16000,-8.5,18600
United States,"Drilling and Boring Machine Tool Setters, Operators, and Tenders, Metal and Plastic",11600,9200,-2400,-20.7,900
United States,"Grinding, Lapping, Polishing, and Buffing Machine Tool Setters, Operators, and Tenders, Metal and Plastic",75400,68200,-7200,-9.5,7400
United States,"Lathe and Turning Machine Tool Setters, Operators, and Tenders, Metal and Plastic",29900,26400,-3500,-11.7,2800
United States,"Milling and Planing Machine Setters, Operators, and Tenders, Metal and Plastic",19800,15700,-4100,-20.7,1400
United States,Machinists,395200,405100,9900,2.5,41600
United States,Metal-Refining Furnace Operators and Tenders,18100,16900,-1200,-6.6,2000
United States,"Pourers and Casters, Metal",8000,6700,-1300,-16.3,700
United States,"Model Makers, Metal and Plastic",5300,4800,-500,-9.4,500
United States,"Patternmakers, Metal and Plastic",2900,2600,-300,-10.3,200
United States,Foundry Mold and Coremakers,15900,13200,-2700,-17.0,1300
United States,"Molding, Coremaking, and Casting Machine Setters, Operators, and Tenders, Metal and Plastic",166000,150500,-15500,-9.3,15700
United States,"Multiple Machine Tool Setters, Operators, and Tenders, Metal and Plastic",135900,138700,2800,2.1,14700
United States,Tool and Die Makers,74300,69700,-4600,-6.2,6700
United States,"Welders, Cutters, Solderers, and Brazers",424700,439100,14400,3.4,48800
United States,"Welding, Soldering, and Brazing Machine Setters, Operators, and Tenders",37700,34800,-2900,-7.7,3700
United States,"Heat Treating Equipment Setters, Operators, and Tenders, Metal and Plastic",20000,17700,-2300,-11.5,1700
United States,"Layout Workers, Metal and Plastic",8400,7800,-600,-7.1,800
United States,"Plating and Coating Machine Setters, Operators, and Tenders, Metal and Plastic",40600,36100,-4500,-11.1,3600
United States,"Tool Grinders, Filers, and Sharpeners",8800,8500,-300,-3.4,1200
United States,"Metal Workers and Plastic Workers, All Other",25900,23500,-2400,-9.3,2300
United States,Prepress Technicians and Workers,29900,23700,-6200,-20.7,2700
United States,Printing Press Operators,175700,154900,-20800,-11.8,15800
United States,Print Binding and Finishing Workers,46500,39400,-7100,-15.3,5300
United States,Laundry and Dry-Cleaning Workers,218600,217400,-1200,-0.5,29000
United States,"Pressers, Textile, Garment, and Related Materials",39900,31400,-8500,-21.3,3300
United States,Sewing Machine Operators,151600,133500,-18100,-11.9,14200
United States,Shoe and Leather Workers and Repairers,12200,11800,-400,-3.3,1400
United States,Shoe Machine Operators and Tenders,3900,3500,-400,-10.3,500
United States,"Sewers, Hand",8600,7900,-700,-8.1,1000
United States,"Tailors, Dressmakers, and Custom Sewers",33900,31700,-2200,-6.5,4200
United States,Textile Bleaching and Dyeing Machine Operators and Tenders,9700,7900,-1800,-18.6,1000
United States,"Textile Cutting Machine Setters, Operators, and Tenders",13900,12300,-1600,-11.5,1000
United States,"Textile Knitting and Weaving Machine Setters, Operators, and Tenders",22100,17900,-4200,-19.0,1800
United States,"Textile Winding, Twisting, and Drawing Out Machine Setters, Operators, and Tenders",32100,27000,-5100,-15.9,2400
United States,"Extruding and Forming Machine Setters, Operators, and Tenders, Synthetic and Glass Fibers",18800,17300,-1500,-8.0,2300
United States,Fabric and Apparel Patternmakers,5300,4700,-600,-11.3,600
United States,Upholsterers,38300,38300,0,0.0,4000
United States,"Textile, Apparel, and Furnishings Workers, All Other",15900,14700,-1200,-7.5,2000
United States,Cabinetmakers and Bench Carpenters,115900,115500,-400,-0.3,12000
United States,Furniture Finishers,21200,21100,-100,-0.5,2400
United States,"Model Makers, Wood",1900,1900,0,0.0,200
United States,"Patternmakers, Wood",1400,1400,0,0.0,200
United States,"Sawing Machine Setters, Operators, and Tenders, Wood",54600,53800,-800,-1.5,6200
United States,"Woodworking Machine Setters, Operators, and Tenders, Except Sawing",80500,79800,-700,-0.9,11100
United States,"Woodworkers, All Other",14700,15200,500,3.4,1900
United States,Nuclear Power Reactor Operators,6400,5400,-1000,-15.6,500
United States,Power Distributors and Dispatchers,11700,11300,-400,-3.4,1000
United States,Power Plant Operators,34900,33200,-1700,-4.9,3000
United States,Stationary Engineers and Boiler Operators,33700,34600,900,2.7,3700
United States,Water and Wastewater Treatment Plant and System Operators,127100,120900,-6200,-4.9,10600
United States,Chemical Plant and System Operators,28600,26000,-2600,-9.1,2800
United States,Gas Plant Operators,14700,13700,-1000,-6.8,1500
United States,"Petroleum Pump System Operators, Refinery Operators, and Gaugers",39700,38900,-800,-2.0,4300
United States,"Plant and System Operators, All Other",12600,12700,100,0.8,1400
United States,Chemical Equipment Operators and Tenders,84400,80300,-4100,-4.9,9000
United States,"Separating, Filtering, Clarifying, Precipitating, and Still Machine Setters, Operators, and Tenders",51000,52300,1300,2.5,6100
United States,"Crushing, Grinding, and Polishing Machine Setters, Operators, and Tenders",32600,31000,-1600,-4.9,3500
United States,"Grinding and Polishing Workers, Hand",30700,24800,-5900,-19.2,2600
United States,"Mixing and Blending Machine Setters, Operators, and Tenders",130700,128800,-1900,-1.5,14900
United States,"Cutters and Trimmers, Hand",10700,7700,-3000,-28.0,800
United States,"Cutting and Slicing Machine Setters, Operators, and Tenders",62300,60300,-2000,-3.2,7300
United States,"Extruding, Forming, Pressing, and Compacting Machine Setters, Operators, and Tenders",73600,71000,-2600,-3.5,7600
United States,"Furnace, Kiln, Oven, Drier, and Kettle Operators and Tenders",23100,23000,-100,-0.4,2400
United States,"Inspectors, Testers, Sorters, Samplers, and Weighers",574000,473100,-100900,-17.6,54400
United States,Jewelers and Precious Stone and Metal Workers,38100,35200,-2900,-7.6,4400
United States,Dental Laboratory Technicians,36500,40500,4000,11.0,5100
United States,Medical Appliance Technicians,15500,17500,2000,12.9,2200
United States,Ophthalmic Laboratory Technicians,29400,32700,3300,11.2,4100
United States,Packaging and Filling Machine Operators and Tenders,394900,400000,5100,1.3,46700
United States,"Coating, Painting, and Spraying Machine Setters, Operators, and Tenders",92300,92200,-100,-0.1,10000
United States,"Painters, Transportation Equipment",58100,60800,2700,4.6,6700
United States,"Painting, Coating, and Decorating Workers",12600,12700,100,0.8,1400
United States,Semiconductor Processors,27200,25100,-2100,-7.7,2800
United States,Photographic Process Workers and Processing Machine Operators,17100,13400,-3700,-21.6,2000
United States,Adhesive Bonding Machine Operators and Tenders,16500,16100,-400,-2.4,2100
United States,"Cleaning, Washing, and Metal Pickling Equipment Operators and Tenders",17800,17900,100,0.6,2800
United States,Cooling and Freezing Equipment Operators and Tenders,9200,9500,300,3.3,1100
United States,Etchers and Engravers,10500,10600,100,1.0,1300
United States,"Molders, Shapers, and Casters, Except Metal and Plastic",46800,47700,900,1.9,5300
United States,"Paper Goods Machine Setters, Operators, and Tenders",98900,89400,-9500,-9.6,9300
United States,Tire Builders,24400,22200,-2200,-9.0,2200
United States,Helpers--Production Workers,354600,385800,31200,8.8,57700
United States,"Production Workers, All Other",244700,249900,5200,2.1,29100
United States,Aircraft Cargo Handling Supervisors,9100,9500,400,4.4,1000
United States,"First-Line Supervisors of Transportation and Material Moving Workers, Except Aircraft Cargo Handling Supervisors",416200,438300,22100,5.3,47800
United States,"Airline Pilots, Copilots, and Flight Engineers",83600,87400,3800,4.5,9100
United States,Commercial Pilots,40700,43800,3100,7.6,4600
United States,Air Traffic Controllers,24300,24600,300,1.2,2300
United States,Airfield Operations Specialists,10200,10900,700,6.9,1100
United States,Flight Attendants,119300,131200,11900,10.0,15300
United States,"Ambulance Drivers and Attendants, Except Emergency Medical Technicians",15600,17300,1700,10.9,2700
United States,"Bus Drivers, Transit and Intercity",183800,195100,11300,6.1,25000
United States,"Bus Drivers, School or Special Client",497500,519100,21600,4.3,66300
United States,Driver/Sales Workers,447800,434100,-13700,-3.1,48800
United States,Heavy and Tractor-Trailer Truck Drivers,1958800,2058500,99700,5.1,238400
United States,Light Truck or Delivery Services Drivers,1001300,1045100,43800,4.4,120700
United States,Taxi Drivers and Chauffeurs,370400,442800,72400,19.5,51300
United States,"Motor Vehicle Operators, All Other",60700,65200,4500,7.4,11000
United States,Locomotive Engineers,32200,31600,-600,-1.9,2900
United States,Locomotive Firers,500,200,-300,-60.0,0
United States,"Rail Yard Engineers, Dinkey Operators, and Hostlers",5500,5500,0,0.0,500
United States,"Railroad Brake, Signal, and Switch Operators",13400,13200,-200,-1.5,1200
United States,Railroad Conductors and Yardmasters,39500,39000,-500,-1.3,3700
United States,Subway and Streetcar Operators,9200,9700,500,5.4,1000
United States,"Rail Transportation Workers, All Other",2700,2700,0,0.0,300
United States,Sailors and Marine Oilers,33000,32100,-900,-2.7,4000
United States,"Captains, Mates, and Pilots of Water Vessels",38700,38000,-700,-1.8,3600
United States,Motorboat Operators,2700,2800,100,3.7,300
United States,Ship Engineers,9000,8700,-300,-3.3,1100
United States,Bridge and Lock Tenders,3300,3400,100,3.0,400
United States,Parking Lot Attendants,150700,150800,100,0.1,23000
United States,Automotive and Watercraft Service Attendants,115000,120600,5600,4.9,18000
United States,Traffic Technicians,7500,8000,500,6.7,900
United States,Transportation Inspectors,30700,31900,1200,3.9,3300
United States,"Transportation Attendants, Except Flight Attendants",25600,26900,1300,5.1,3600
United States,"Transportation Workers, All Other",38100,40700,2600,6.8,4400
United States,Conveyor Operators and Tenders,22900,22600,-300,-1.3,2700
United States,Crane and Tower Operators,46800,49100,2300,4.9,5800
United States,Dredge Operators,1300,1400,100,7.7,200
United States,Excavating and Loading Machine and Dragline Operators,49700,53300,3600,7.2,6500
United States,"Loading Machine Operators, Underground Mining",2700,2700,0,0.0,300
United States,Hoist and Winch Operators,3200,3100,-100,-3.1,400
United States,Industrial Truck and Tractor Operators,615000,642000,27000,4.4,73400
United States,Cleaners of Vehicles and Equipment,408500,433000,24500,6.0,63700
United States,"Laborers and Freight, Stock, and Material Movers, Hand",2953800,3097900,144100,4.9,434700
United States,Machine Feeders and Offbearers,66200,66300,100,0.2,8800
United States,"Packers and Packagers, Hand",673400,650000,-23400,-3.5,93000
United States,Gas Compressor and Gas Pumping Station Operators,3600,3500,-100,-2.8,400
United States,"Pump Operators, Except Wellhead Pumpers",11600,12700,1100,9.5,1600
United States,Wellhead Pumpers,14400,14300,-100,-0.7,1700
United States,Refuse and Recyclable Material Collectors,133000,143900,10900,8.2,20200
United States,Mine Shuttle Car Operators,1700,1300,-400,-23.5,100
United States,"Tank Car, Truck, and Ship Loaders",9100,9200,100,1.1,1200
United States,"Material Moving Workers, All Other",27600,28900,1300,4.7,3700
